R 900 500

NO ./cub_skin/texture/N.xpm
SO ./cub_skin/texture/S.xpm          
WE ./cub_skin/texture/W.xpm     
EA cub_skin/texture/E.xpm     
S ./cub_skin/texture/plant.xpm

F     184,146,67
C     255, 255   ,   50   



        1111111111111111111111111
        1000000S00110000000000001
        1011000001110000002000001
        1001000000000000000000001
111111111011000001110000000000001
100000000011000001110111111111111
11110111111111011100000010001
11110111111111011101010010001
11000000110101011100000010001
10002000000000001100000010001
10000000000000001101010010001
1100000111010101111101111000111
11110111 1110101 101111010001
11111111 1111111 111111111111